NO ./assets/t1.xpm
SO ./assets/t1.xpm
WE ./assets/t1.xpm
EA ./assets/t1.xpm


C 102,178,255
F 192,192,192

        1111111111111111111111111
        1000000000110000000000001
        121100S001110000003000001
        1001000000200000000000001
111111111011000001110000001000001
100000000011000001110111111111111
11110111111111011100000010001
11110111111111011101010010001
11000000110101011100000010001
10000000000000001100000010001
10000000000000001101010010001
1100000111010101111101111000111
11110111 1110101 101111010001
11111111 1111111 111111111111
