NO ./assets/t1.xpm
SO ./assets/t2.xpm
WE ./assets/t3.xpm
EA ./assets/t5.xpm

DOOR ./assets/door2.xpm
SPRITE ./assets/mushroom_cloud.xpm

C 102,178,255
F 192,192,192

111111111111111111111111
1000000000000030000001
1000000000000000000001
10000000E0000000000001
1000000000000000000001
1000000000000000000001
1000000000020000000001
111111111111111111111111
