NO ./assets/t1.xpm
SO ./assets/t2.xpm
WE ./assets/t3.xpm
EA ./assets/t5.xpm

F 120,31,5
C 120,30,50

111111111111111111
100000000000000111
111000000111001111
111000000111001111
111000000111001111
111000000111001111
1110000111000N1111
  111111 1111111  