NO ./assets/t1.xpm
SO ./assets/t2.xpm
WE ./assets/t3.xpm
EA ./assets/t4.xpm

F 120,31,5
C 120,30,50

111111111111111111
1000000000000N0111
111000000111001111
111000000111001111
111000000111001111
111000000111001111
111000011100001111
  111111 1111111  