NO ./assets/t1.xpm
SO ./assets/t2.xpm
WE ./assets/t3.xpm
EA ./assets/t4.xpm

C 102,178,255
F 192,192,192

111111111111
10100001
10200W01
10100001
1000000111
10000101
10000001
11111111
