NO ./assets/0001.xpm
SO ./assets/0001.xpm
WE ./assets/0001.xpm
EA ./assets/0001.xpm

C 102,178,255
F 192,192,192

11111111
10100001
10100W01
10100001
10000001
10000101
10000001
11111111
