NO ./assets/t1.xpm
SO ./assets/t2.xpm
WE ./assets/t3.xpm
EA ./assets/t4.xpm

DOOR ./assets/door2.xpm
SPRITE ./assets/mushroom_cloud.xpm

C 102,178,255
F 192,192,192

111111111111
101000000001
10000W000001
101000300001
100001000001
100002000001
100001000001
111111111111
